OOVBNOOOOOVBNOOO
OOOOOOZXXCOOOOOO
OOOOOOVBBNOOOOOO
OOOOOOOOOOOOOOOO
OOOOOOOOOOOOOOOO
OOOOOOOOOOOOOOOO
LOOOOOOOOOOOOOOL
UIOOOOOOOOOOOOYU
UHIOOOOOOOOOOYKU
UUUILOOOOOOLYUUU
UUJUUIOOOOYUUJUU
UUUJUUIOOYUUJUUU
OOOOOOOOOOOOOOOO
OOOOOOOOOOOOOOOO