WE++++++++++++QW
SD++M.++++M.++AS
++++++++++++++++
++++++++++++++++
++++++M,,.++++++
++++++++++++++++
++++++++++++++++
++++++++++++++++
++++M.++++M.++++
++++++++++++++++
WE++++++++++++QW
SD++++++++++++AS
++++++++++++++++
++++++++++++++++