++++++++++++++++
++++++++++++++++
TTTTTT++++TTTTTT
++++++++++++++++
++++++++++++++++
++++0TTTTTT0++++
TT++++++++++++TT
++++++++++++++++
++++++++++++++++
TTTTTT++++TTTTTT
++++++++++++++++
++++++++++++++++
RRRRRRRRRRRRRRRR
FFFFFFFFFFFFFFFF