OOVBNOOOOOVBNOOO
OOOOOOZXXCOOOOOO
OOOOOOVBBNOOOOOO
OOOOOOOOOOOOOOOO
OOOOOOOOOOOOOOOO
OOOOOOOOOOOOOOOO
LOOOOOOOOOOOOOOL
UIOOOOOOOOOOOOYU
UHIOOOOOOOOOOYKU
UUUIOOOOOOOOYUUU
UUJULIOOOOYLUJUU
UUUJUUIOOYUUJUUU
OOOOOOOOOOOOOOOO
OOOOOOOOOOOOOOOO