WEOOOOOOOOOOOOQW
SDOOM.OOOOM.OOAS
OOOOOOOOOOOOOOOO
OOOOOOOOOOOOOOOO
OOOOOOM,,.OOOOOO
OOOOOOOOOOOOOOOO
OOOOOOOOOOOOOOOO
OOOOOOOOOOOOOOOO
OOOOM.OOOOM.OOOO
OOOOOOOOOOOOOOOO
WEOOOOOOOOOOOOQW
SDOOOOOOOOOOOOAS
OOOOOOOOOOOOOOOO
OOOOOOOOOOOOOOOO