OOOOOOOOOOOOOOOO
OOOOOOOOOOOOOOOO
TTTTTTOOOOTTTTTT
OOOOOOOOOOOOOOOO
OOOOOOOOOOOOOOOO
OOOO0TTTTTT0OOOO
TTOOOOOOOOOOOOTT
OOOOOOOOOOOOOOOO
OOOOOOOOOOOOOOOO
TTTTTTOOOOTTTTTT
OOOOOOOOOOOOOOOO
OOOOOOOOOOOOOOOO
RRRRRRRRRRRRRRRR
FFFFFFFFFFFFFFFF